QE##Q   E# E#Q E#Q    ##
  ##                  ##
  E#                    
     #    C#Z           
          ###           
                  ##Z   
             #    ###   
             #          
           ###      C#Z 
########Z C# #     C####
###############Z   #####
 ################ C#####
#################C###Q##
#####QE#################
<---------------------->