###########
###########
##Q     E##
##       E#
##        E
E#         
 E       Z 
         #Z
Z        ##
#Z       ##
##Z     C##
###########
<--------->