############################################################
#                                                          # 
#                                                          # 
#                                                          # 
#                                                          #    
#                                                          # 
#                                                          # 
#                                                          # 
#                                                          #    
#                                                          # 
#                                                          # 
#                                                          #    
#                                                          # 
#                                                          #
#                                                          # 
#                                                          #    
#                                                          # 
#                                                          # 
#                                                          # 
############################################################
<---------------------------->